10 30
##############################
#                            #
#                            #
#      ##############        #
#      #            #        #
#      #            #        #
#      ##############        #
#                       @    #
#                            #
##############################