################################################################################
#									      0#
#									       #
#									       #
#									       #
#									       #
#									       #
#									       #
#									       #
#									       #
#									       #
#									       #
#									       #
#	$							  	       #
#									       #
#							$		       #
#									       #
#									       #
#									       #
#									       #
#									       #
#									       #
#		$							       #
#									       #
#									       #
#				$					       #
#									       #
#									       #
#									       #
#									       #
#									       #
#									       #
#									       #
#									       #
#						$			       #
#									       #
#									       #
#						$			       #
#									       #
#									       #
#		#							       #
#    ############							       #
#    #									       #
#    # 									       #
######									       #
#									       #
#									       #
################################################################################
