49 80
________________________________________________________________________________
|         ################################# [d*b] [d*b]               :        |
|[d*b]    ###################################################         :  d***b |
|[d*b]    ###################################################         :   -=-  |
|[d*b]    ###################################################         :        |
|[d*b]  [d*b]                                                            ......|
|                                                                              |
|######                                                                        |
|######                                                                        |
| ######                      #################################################|
| ######                      #################################################|
|  ######                     #################################################|
|  ######                     #################################################|
|   ######                #################################################    |
|   ######                #################################################    |
|    ######               #################################################    |
|    ######               #################################################    |
|     ######                                   [d*b]                           |
|     ######                                                                   |
|      ######                                  [d*b]                           |
|      ######                                                                  |
|      ######             ##################   [d*b]     ##################    |
|      ######             ############                         ############    |
|      ######             ###### [d*b]       [d*b][d*b]        [d*b] ######    |
|      ######             ###### [d*b]                         [d*b] ######    |
|      ######             ############                         ############    |
|      ######             ################## [d*b][d*b]  ##################    |
|      ######             #################################################    |
|      ######             #################################################    |
|                         #################################################    |
|      [d*b]              #################################################    |
|      [d*b]              #################################################    |
|                                                                              |
|      ######                                                                  |
|      ######                                                                  |
|      ######             #################################################    |
|      ######             ##############################################       |
|      ######             ############################################## [d*b] |
|      ######       ###         ########################################       |
|      ######       ###         ######################################## [d*b] |
|      ######       ###  [d*b]  ########################################       |
|      ######       ###         ######################################## [d*b] |
|      ######       ###  [d*b]  #############################                  |
|                   ###         #############################                  |
|....               ###  [d*b]  #############################   [d*b]  [d*b]   |
|                   ###         #############################                  |
|      :       ##############################################   [d*b]  [d*b]   |
| @    :       ##############################################                  |
|______________________________________________________________________________|